11111111111111111111111111111111111111111111
1PCCCCCCCCCCCCCCCCCCCECCCCCCCCCCCCCCCCCCCCC1
11111111111111111111111111111111111111111111
