1111111111111111111111111111111111111111111
1P00000000000000000000000000000000000000001
10000000000000000CCCCCCCCCCCCCCCCCCCCC00001
10000000000C0000100000000000000000000C00001
1000000000010101010101010101010101000000011
10000000001000000100000000000000000000C0001
10000000000000000000000000000000000000000E1
1111111111111111111111111111111111111111111
