1111111111111111111111111111111111111111111
1100000000000000000000000000000000000000001
10000000000000000CCCCCCPCCCCCCCCCCCCCC00001
10000000000C0000100000000000000000000C00001
10000000001000000100000000EP0000000000C0001
1111111111111111111111111111111111111111111

