1111111111111111111111111111111111111
1P000000000000000000000000000E0000001
1000000000000000000000000000000000001
100C000000000000000CCCCCCCCCCC0000001
100C0000000000000000000000000C0000001
100C0000000000000000000000000C0000001
100C0000C00000000000000000000C0000001
100C0000C0000000000CCCCCCCCCCC0000001
100C0000C0000000000C00000000000000001
100CCCCCCCCC0000000C00000000000000001
10000000C0000000000CCCCCCCCCCC0000001
1000000000000000000000000000000000001
1111111111111111111111111111111111111
